027 024
1533 1533 1533 1533 1533 1533 1533 1533 1533 1533 1533 1533 1533 1533 1533 1533 1533 1533 1533 1533 1533 1533 1533 1533
1533 1533 1533 1533 1533 1533 1533 1533 1533 1533 1533 1533 1533 1533 1533 1533 1533 1533 1533 1533 1533 1533 1533 1533
1533 1533 1533 1533 1533 1533 1533 1533 1533 1533 1533 1533 1533 1533 1533 1533 1533 1533 1533 1533 1533 1533 1533 1533
1533 1533 1533 1533 1533 1533 1533 1533 1533 1533 1533 1533 1533 1533 1533 1533 1533 1533 1533 1533 1533 1533 1533 1533
1533 1533 1533 1533 1533 1533 1533 1533 1533 1533 1533 1533 1533 1533 1533 1533 1533 1533 1533 1533 1533 1533 1533 1533
1533 1533 1533 1533 1533 1533 1533 1533 1533 1533 1533 1533 1533 1533 1533 1533 1533 1533 1533 1533 1533 1533 1533 1533
0259 0259 0259 0259 0259 0259 0259 0259 0259 0259 0259 0259 0259 0259 0259 0259 0259 0259 0259 0259 0259 0259 0259 0259
1533 1533 0259 0259 0259 0259 0259 0259 0259 0259 0259 0259 0259 0259 0259 0259 0259 0259 0259 0259 0259 0259 0259 0259
0259 0259 0259 0259 0259 0259 0259 0259 0259 0259 0259 0259 0259 0259 0259 0259 0259 0259 0259 0259 0259 0259 0259 0259
0259 0259 0259 0259 0259 0259 0259 0259 0259 0259 0259 0259 0259 0259 0259 0259 0259 0259 0259 0259 0259 0259 0259 0259
0259 0259 0259 0259 0259 0259 0259 0259 0259 0259 0259 0259 0259 0259 0259 0259 0259 0259 0259 0259 0259 0259 0259 0259
0259 0259 0259 0259 0259 0259 0259 0259 0259 0259 0259 0259 0259 0259 0259 0259 0259 0259 0259 0259 0259 0259 0259 0259
0259 0259 0259 0259 0259 0259 0259 0259 0259 0259 0259 0259 0259 0259 0259 0259 0259 0259 0259 0259 0259 0259 0259 0259
0259 0259 0259 0259 0259 0259 0259 0259 0259 0259 0259 0259 0259 0259 0259 0259 0259 0259 0259 0259 0259 0259 0259 0259
0259 0259 0259 0259 0259 0259 0259 0259 0259 0259 0259 0259 0259 0259 0259 0259 0259 0259 0259 0259 0259 0259 0259 0259
0259 0259 0259 0259 0259 0259 0259 0259 0259 0259 0259 0259 0259 0259 0259 0259 0259 0259 0259 0259 0259 0259 0259 0259
0259 0259 0259 0259 0259 0259 0259 0259 0259 0259 0259 0259 0259 0259 0259 0259 0259 0259 0259 0259 0259 0259 0259 0259
0259 0259 0259 0259 0259 0259 0259 0259 0259 0259 0259 0259 0259 0259 0259 0259 0259 0259 0259 0259 0259 0259 0259 0259
0259 0259 0259 0259 0259 0259 0259 0259 0259 0259 0259 0259 0259 0259 0259 0259 0259 0259 0259 0259 0259 0259 0259 0259
0259 0259 0259 0259 0259 0259 0259 0259 0259 0259 0259 0259 0259 0259 0259 0259 0259 0259 0259 0259 0259 0259 0259 0259
0259 0259 0259 0259 0259 0259 0259 0259 0259 0259 0259 0259 0259 0259 0259 0259 0259 0259 0259 0259 0259 0259 0259 0259
0259 0259 0259 0259 0259 0259 0259 0259 0259 0259 0259 0259 0259 0259 0259 0259 0259 0259 0259 0259 0259 0259 0259 0259
0259 0259 0259 0259 0259 0259 0259 0259 0259 0259 0259 0259 0259 0259 0259 0259 0259 0259 0259 0259 0259 0259 0259 0259
1533 1533 0259 0259 0259 0259 0259 0259 0259 0259 0259 0259 0259 0259 0259 0259 0259 0259 0259 0259 0259 0259 1533 1533
1533 1533 0259 0259 0259 0259 0259 0259 0259 0259 0259 0259 0259 0259 0259 0259 0259 0259 0259 0259 0259 0259 1533 1533
1533 1533 1533 1533 1533 1533 1533 1533 1533 1533 1533 1533 1533 1533 1533 1533 1533 1533 1533 1533 1533 1533 1533 1533
1533 1533 1533 1533 1533 1533 1533 1533 1533 1533 1533 1533 1533 1533 1533 1533 1533 1533 1533 1533 1533 1533 1533 1533
