044 049
1565 1565 1565 1565 1560 0264 0264 1542 0000 0000 0000 0000 0000 0000 0000 0000 0000 0000 0000 0000 0000 0000 0000 0000 0000 0000 0000 0000 0000 0000 0000 0000 0000 0000 0000 0000 0000 0000 0000 0000 0000 0000 0000 0000 0000 0000 0000 0000 0000
0264 0264 0264 0264 0264 1560 0264 1542 0000 0000 0000 0000 0000 0000 0000 0000 0000 0000 0000 0000 0000 0000 0000 0000 0000 0000 0000 0000 0000 0000 0000 0000 0000 0000 0000 0000 0000 0000 0000 0000 0000 0000 0000 0000 0000 0000 0000 0000 0000
0264 0264 0264 0264 0264 1541 0264 1542 0000 0000 0000 0000 0000 0000 0000 0000 0000 0000 0000 0000 0173 0174 0175 0000 0000 0000 0000 0000 0000 0000 0000 0000 0000 0000 0000 0000 0000 0000 0000 0000 0000 0000 0000 0000 0000 0000 0000 0000 0000
1565 1565 1565 1560 0264 0264 1560 1542 0000 0000 0000 0000 0000 0000 0000 0000 0000 0000 0000 0000 0176 0177 0178 0000 0000 0000 0000 0000 0000 0000 0000 0000 0000 0000 0000 0000 0000 0000 0000 0000 0000 0000 0000 0000 0000 0000 0000 0000 0000
0264 0264 0264 0264 1560 0264 1541 1542 0000 0000 0000 0000 0000 0000 0000 0000 0000 0000 0000 0000 0176 0177 0178 0000 0000 0000 0000 0000 0000 0000 0000 0000 0000 0000 0000 0000 0000 0000 0000 0000 0000 0000 0000 0000 0000 0000 0000 0000 0000
0264 0264 0264 0264 1541 0264 1541 1542 0000 0000 0000 0000 0000 0000 0000 0000 0000 0000 0000 0000 0176 0177 0178 0000 0000 0000 0000 0000 0000 0000 0000 0000 0000 0000 0000 0000 0000 0000 0000 0000 0000 0000 0000 0000 0000 0000 0000 0000 0000
0264 0264 0264 0264 1541 0264 1541 1542 0000 0000 0000 0000 0000 0000 0000 0000 0000 0000 0000 0000 0176 0177 0178 0000 0000 0000 0000 0000 0000 0000 0000 0000 0000 0000 0000 0000 0000 0000 0000 0000 0000 0000 0000 0000 0000 0000 0000 0000 0000
0264 0264 0264 0264 1541 0264 1541 1542 0000 0000 0000 0000 0000 0000 0000 0000 0000 0000 0000 0000 0176 0177 0178 0000 0000 0000 0000 0000 0000 0173 0174 0174 0174 0174 0174 0174 0174 0174 0174 0174 0174 0175 0000 0000 0000 0000 0000 0000 0000
0264 0264 0264 0264 1541 0264 1541 1542 0000 0000 0000 0000 0000 0000 0000 0000 0000 0000 0000 0000 0176 0177 0178 0000 0000 0000 0000 0000 0000 0176 0177 0177 0177 0177 0177 0177 0177 0177 0177 0177 0177 0178 0000 0000 0000 0000 0000 0000 0000
0264 0264 0264 0264 1541 0264 1541 1542 0000 0000 0000 0000 0000 0000 0000 0000 0000 0000 0000 0000 0176 0177 0177 0174 0174 0174 0174 0174 0174 0177 0177 0177 0180 0180 0180 0180 0180 0180 0180 0177 0177 0178 0000 0000 0000 0000 0000 0000 0000
0264 0264 0264 0264 1541 0264 1541 1542 0000 0000 0000 0000 0000 0000 0000 0000 0000 0000 0000 0000 0176 0177 0177 0177 0177 0177 0177 0177 0177 0177 0177 0178 0000 0000 0000 0000 0000 0000 0000 0176 0177 0178 0000 0000 0000 0000 0000 0000 0000
0264 0264 0264 0264 1541 0264 1541 1542 0000 0000 0000 0000 0000 0000 0000 0000 0000 0000 0000 0000 0176 0177 0177 0180 0180 0180 0180 0180 0180 0180 0180 0181 0000 0000 0000 0000 0000 0000 0000 0176 0177 0178 0000 0000 0000 0000 0000 0000 0000
0264 0264 0264 1555 1557 0264 1541 1542 0000 0000 0000 0000 0000 0000 0000 0000 0000 0000 0000 0000 0176 0177 0178 0000 0000 0000 0000 0000 0000 0000 0000 0000 0000 0000 0000 0000 0000 0000 0000 0176 0177 0178 0000 0000 0000 0000 0000 0000 0000
0264 0264 0264 1541 0264 0264 1541 1542 0000 0000 0000 0000 0000 0000 0000 0000 0000 0000 0000 0000 0176 0177 0178 0000 0000 0000 0000 0000 0000 0000 0000 0000 0000 0000 0000 0000 0000 0000 0000 0176 0177 0178 0000 0000 0000 0000 0000 0000 0000
1564 1564 1564 1557 0264 1555 1557 1542 0000 0000 0000 0000 0000 0000 0000 0000 0000 0000 0000 0000 0176 0177 0178 0000 0000 0000 0000 0000 0000 0000 0000 0000 0000 0000 0000 0000 0000 0000 0000 0179 0180 0181 0000 0000 0000 0000 0000 0000 0000
0264 0264 0264 0264 1555 1557 0264 1542 0000 0000 0000 0000 0000 0000 0000 0000 0000 0000 0000 0000 0176 0177 0178 0000 0000 0000 0000 0000 0000 0000 0000 0000 0000 0000 0000 0000 0000 0000 0000 0000 0000 0000 0000 0000 0000 0000 0000 0000 0000
1564 1564 1564 1564 1557 0264 0264 1542 0000 0000 0000 0000 0000 0000 0000 0000 0000 0000 0000 0000 0176 0177 0178 0000 0000 0000 0000 0000 0000 0000 0000 0000 0000 0000 0000 0000 0000 0000 0000 0077 0000 0077 0000 0000 0000 0000 0000 0000 0000
0264 0264 0264 0264 0264 1555 1553 1558 0000 0000 0000 0000 0000 0000 0000 0000 0000 0000 0000 0000 0176 0177 0178 0000 0000 0000 0000 0000 0000 0000 0000 0000 0000 0000 0000 0000 0000 0000 0077 0000 0077 0000 0000 0000 0000 0000 0000 0000 0000
1553 1553 1553 1553 1553 1554 0000 0000 0000 0000 0000 0000 0000 0000 0000 0000 0000 0000 0000 0000 0176 0177 0178 0000 0000 0000 0000 0000 0000 0000 0000 0000 0000 0000 0000 0000 0000 0000 0000 0000 0000 0000 0000 0000 0000 0000 0000 0000 0000
0000 0000 0000 0000 0000 0000 0000 0000 0000 0000 0000 0000 0000 0000 0000 0000 0000 0000 0000 0000 0176 0177 0178 0000 0000 0000 0000 0000 0000 0000 0000 0000 0000 0000 0000 0000 0000 0000 0000 0000 0000 0000 0000 0000 0000 0000 0000 0000 0000
0007 0007 0007 0007 0007 0007 0007 0007 0008 0000 0000 0000 0000 0173 0174 0174 0174 0174 0174 0174 0177 0177 0178 0000 0000 0000 0000 0000 0000 0173 0174 0175 0000 0000 0000 0000 0000 0000 0000 0173 0174 0175 0000 0000 0000 0000 0000 0000 0000
0004 0004 0004 0004 0004 0004 0004 0004 0011 0000 0000 0000 0000 0176 0177 0177 0177 0177 0177 0177 0177 0177 0178 0000 0000 0000 0000 0000 0000 0176 0177 0178 0000 0000 0000 0000 0000 0000 0000 0176 0177 0178 0000 0000 0000 0000 0000 0000 0000
0013 0013 0013 0013 0013 0013 0013 0013 0014 0000 0000 0000 0000 0179 0180 0180 0180 0180 0180 0180 0177 0177 0178 0000 0000 0000 0000 0000 0000 0176 0177 0178 0000 0000 0000 0000 0000 0000 0000 0176 0177 0178 0000 0000 0000 0000 0000 0000 0000
1536 1536 1536 1536 1536 1536 1563 0000 0000 0000 0000 0000 0000 0000 0000 0000 0000 0000 0000 0000 0177 0177 0177 0174 0174 0174 0174 0174 0174 0177 0177 0177 0174 0174 0177 0177 0174 0174 0174 0176 0177 0178 0000 0000 0000 0000 0000 0000 0000
0264 0264 0264 0264 0264 0264 1542 0000 0000 0000 0000 0000 0000 0000 0000 0000 0000 0000 0000 0000 0176 0177 0177 0177 0177 0177 0177 0177 0177 0177 0177 0177 0177 0177 0177 0177 0177 0177 0177 0177 0177 0178 0000 0000 0000 0000 0000 0000 0000
1561 1559 1559 1559 1559 1560 1542 0000 0000 0000 0000 0000 0000 0000 0000 0000 0000 0000 0000 0000 0176 0177 0177 0180 0180 0180 0180 0180 0180 0180 0177 0177 0177 0180 0180 0180 0180 0180 0180 0177 0177 0178 0000 0000 0000 0000 0000 0000 0000
1540 0264 0264 0264 0264 1541 1542 0000 0000 0000 0000 0000 0000 0000 0000 0000 0000 0000 0000 0000 0176 0177 0178 0000 0000 0000 0000 0000 0000 0000 0176 0177 0178 0000 0077 0000 0077 0000 0000 0176 0177 0178 0000 0000 0000 0000 0000 0000 0000
1540 0264 0264 0264 0264 1541 1542 0000 0000 0000 0000 0000 0000 0000 0000 0000 0000 0000 0000 0000 0176 0177 0178 0000 0000 0000 0000 0000 0000 0000 0176 0177 0178 0000 0000 0077 0000 0077 0000 0176 0177 0178 0000 0000 0000 0000 0000 0000 0000
1540 0264 0264 0264 0264 1541 1542 0000 0000 0000 0000 0000 0000 0000 0000 0000 0000 0000 0000 0000 0176 0177 0178 0000 0000 0000 0000 0000 0000 0000 0176 0177 0178 0000 0077 0000 0077 0000 0000 0176 0177 0178 0000 0000 0000 0000 0000 0000 0000
1540 0264 0264 0264 0264 1541 1542 0000 0000 0000 0000 0000 0000 0000 0000 0000 0000 0000 0000 0000 0176 0177 0178 0000 0000 0000 0000 0000 0000 0000 0176 0177 0178 0000 0000 0077 0000 0077 0000 0176 0177 0178 0000 0000 0000 0000 0000 0000 0000
1540 0264 0264 0264 0264 1541 1542 0000 0000 0000 0000 0000 0265 0265 0265 0265 0000 0000 0000 0000 0176 0177 0177 0174 0174 0174 0177 0174 0174 0174 0177 0177 0177 0174 0174 0174 0174 0174 0174 0177 0177 0178 0000 0000 0000 0000 0000 0000 0000
1540 0264 0264 0264 0264 1541 1542 0000 0000 0000 0000 0000 0265 0265 0265 0265 0000 0000 0000 0000 0176 0177 0177 0177 0177 0177 0177 0177 0177 0177 0177 0177 0177 0177 0177 0177 0177 0177 0177 0177 0177 0178 0000 0000 0000 0000 0000 0000 0000
0264 0264 0264 0264 0264 1541 1542 0000 0000 0000 0000 0000 0265 0265 0265 0265 0000 0000 0000 0000 0179 0180 0180 0180 0180 0180 0180 0180 0180 0180 0180 0180 0180 0180 0180 0180 0180 0180 0180 0180 0180 0181 0000 0000 0000 0000 0000 0000 0000
0264 0264 0264 0264 0264 1541 1542 0000 0000 0000 0000 0000 0000 0000 0000 0000 0000 0000 0000 0000 0000 0000 0000 0000 0000 0000 0000 0000 0000 0000 0000 0000 0000 0000 0000 0000 0000 0000 0000 0000 0000 0000 0000 0000 0000 0000 0000 0000 0000
0264 0264 0264 0264 0264 1541 1542 0000 0000 0000 0000 0000 0000 0000 0000 0000 0000 0000 0000 0000 0000 0000 0000 0000 0000 0000 0000 0000 0077 0000 0077 0000 0077 0000 0000 0000 0077 0000 0077 0000 0077 0000 0000 0000 0000 0000 0000 0000 0000
0264 0264 0264 0264 1555 1557 1542 0000 0000 0000 0000 0000 0000 0000 0006 0007 0007 0007 0007 0007 0007 0007 0007 0007 0007 0007 0007 0007 0007 0007 0007 0007 0007 0007 0007 0007 0007 0007 0007 0008 0000 0000 0000 0000 0000 0000 0000 0000 0000
0264 0264 0264 0264 1541 0264 1542 0000 0000 0000 0000 0000 0000 0000 0009 0004 0004 0004 0004 0004 0004 0004 0004 0004 0004 0004 0004 0004 0004 0004 0004 0004 0004 0004 0004 0004 0004 0004 0004 0011 0000 0000 0000 0000 0000 0000 0000 0000 0000
0264 0264 0264 0264 1541 1555 1558 0000 0000 0000 0000 0000 0000 0000 0009 0004 0004 0004 0004 0004 0004 0004 0004 0004 0004 0004 0004 0004 0004 0004 0004 0004 0004 0004 0004 0004 0004 0004 0004 0011 0000 0000 0000 0000 0000 0000 0000 0000 0000
0264 0264 0264 0264 1541 1542 0000 0000 0000 0000 0000 0000 0000 0000 0012 0013 0013 0013 0013 0013 0013 0013 0004 0004 0004 0004 0013 0013 0013 0013 0013 0013 0013 0013 0013 0013 0013 0013 0013 0014 0000 0000 0000 0000 0000 0000 0000 0000 0000
0264 0264 0264 0264 1541 1542 0000 0000 0000 0000 0000 0000 0000 0000 0000 0000 0000 0000 0000 0000 0000 0000 0009 0004 0004 0011 0000 0000 0000 0000 0000 0000 0000 0000 0000 0000 0000 0000 0000 0000 0000 0000 0000 0000 0000 0000 0000 0000 0000
0264 0264 0264 0264 1541 1542 0000 0000 0000 0000 0000 0000 0000 0000 0000 0000 0000 0000 0000 0000 0000 0000 0009 0004 0004 0011 0000 0000 0000 0000 0000 0000 0000 0000 0000 0000 0000 0000 0000 0000 0000 0000 0000 0000 0000 0000 0000 0000 0000
0264 0264 0264 0264 1541 1542 0000 0000 0000 0000 0000 0000 0000 0000 0000 0000 0000 0000 0000 0000 0000 0000 0009 0004 0004 0011 0000 0000 0000 0000 0000 0000 0000 0000 0000 0000 0000 0000 0000 0000 0000 0000 0000 0000 0000 0000 0000 0000 0000
0264 0264 0264 0264 1541 1542 0000 0000 0000 0000 0000 0000 0000 0000 0000 0000 0000 0000 0000 0000 0000 0000 0009 0004 0004 0011 0000 0000 0000 0000 0000 0000 0000 0000 0000 0000 0000 0000 0000 0000 0000 0000 0000 0000 0000 0000 0000 0000 0000
0264 0264 0264 0264 1541 1542 0000 0000 0000 0000 0000 0000 0000 0000 0000 0000 0000 0000 0000 0000 0000 0000 0009 0004 0004 0011 0000 0000 0000 0000 0000 0000 0000 0000 0000 0000 0000 0000 0000 0000 0000 0000 0000 0000 0000 0000 0000 0000 0000
