045 049
0000 0000 0000 0000 0000 0000 0000 0000 0000 0000 0000 0000 0000 0000 0000 0000 0000 0000 0000 0000 0000 0000 0000 0000 0000 0000 0000 0000 0000 0000 0000 0000 0000 0000 0000 0000 0000 0000 0000 0000 0000 0000 0000 0000 0000 0000 0000 0000 0000
0000 0000 0000 0000 0000 0000 0000 0000 0000 0000 0000 0000 0000 0000 0000 0000 0000 0000 0000 0000 0000 0000 0000 0000 0000 0000 0000 0000 0000 0000 0000 0000 0000 0000 0000 0000 0000 0000 0000 0000 0000 0000 0000 0000 0000 0000 0000 0000 0000
0000 0000 0000 0000 0000 0000 0000 0000 0000 0000 0000 0000 0000 0000 0000 0000 0000 0000 0000 0000 0000 0000 0000 0000 0000 0000 0000 0000 0000 0000 0000 0000 0000 0000 0000 0000 0000 0000 0000 0000 0000 0000 0000 0000 0000 0000 0000 0000 0000
0000 0000 0000 0000 0000 0000 0000 0000 0000 0000 0000 0000 0000 0000 0000 0000 0000 0000 0000 0000 0000 0000 0000 0000 0000 0000 0000 0000 0000 0000 0000 0000 0000 0000 0000 0000 0000 0000 0000 0000 0000 0000 0000 0000 0000 0000 0000 0000 0000
0000 0000 0000 0000 0000 0000 0000 0000 0000 0000 0000 0000 0000 0000 0000 0000 0000 0000 0000 0000 0000 0000 0000 0000 0000 0000 0000 0000 0000 0000 0000 0000 0000 0000 0000 0000 0000 0000 0000 0000 0000 0000 0000 0000 0000 0000 0000 0000 0000
0000 0000 0000 0000 0000 0000 0000 0000 0000 0000 0000 0000 0000 0000 0000 0000 0000 0000 0000 0000 0000 0000 0000 0000 0000 0000 0000 0000 0000 0000 0000 0000 0000 0000 0000 0000 0000 0000 0000 0000 0000 0000 0000 0000 0000 0000 0000 0000 0000
0000 0000 0000 0000 0000 0000 0000 0000 0000 0000 0000 0000 0000 0000 0000 0000 0000 0000 0000 0000 0000 0000 0000 0000 0000 0000 0000 0000 0000 0000 0000 0000 0000 0000 0000 0000 0000 0000 0000 0000 0000 0000 0000 0000 0000 0000 0000 0000 0000
0000 0000 0000 0000 0000 0000 0000 0000 0000 0000 0000 0000 0000 0000 0000 0000 0000 0000 0000 0000 0000 0000 0000 0000 0000 0000 0000 0000 0000 0000 0000 0000 0000 0000 0000 0000 0000 0000 0000 0000 0000 0000 0000 0000 0000 0000 0000 0000 0000
0000 0000 0000 0000 0000 0000 0000 0000 0000 0000 0000 0000 0000 0000 0000 0000 0000 0000 0000 0000 0000 0000 0000 0000 0000 0000 0000 0000 0000 0000 0000 0000 0000 0000 0000 0000 0000 0000 0000 0000 0000 0000 0000 0000 0000 0000 0000 0000 0000
0000 0000 0000 0000 0000 0000 0000 0000 0000 0000 0000 0000 0000 0000 0000 0000 0000 0000 0000 0000 0000 0000 0000 0000 0000 0000 0000 0000 0000 0000 0000 0000 0000 0000 0000 0000 0000 0000 0000 0000 0000 0000 0000 0000 0000 0000 0000 0000 0000
0000 0000 0000 0000 0000 0000 0000 0000 0077 0000 0077 0000 0000 0000 0000 0000 0000 0000 0000 0000 0000 0000 0000 0000 0000 0077 0000 0077 0000 0077 0000 0077 0000 0077 0000 0000 0000 0000 0000 0000 0000 0000 0000 0000 0000 0000 0000 0000 0000
0000 0000 0000 0000 0000 0000 0000 0000 0000 0077 0000 0000 0000 0000 0000 0000 0000 0000 0000 0000 0000 0000 0000 0000 0000 0000 0077 0000 0077 0000 0077 0000 0077 0000 0000 0000 0000 0000 0000 0000 0000 0000 0000 0000 0000 0000 0000 0000 0000
0000 0000 0000 0000 0000 0000 0000 0000 0000 0000 0077 0000 0000 0000 0000 0000 0204 0204 0000 0000 0000 0077 0000 0000 0000 0000 0000 0000 0000 0000 0000 0000 0000 0000 0000 0000 0000 0000 0000 0000 0000 0000 0000 0000 0000 0000 0000 0000 0000
0000 0000 0000 0000 0000 0000 0000 0000 0000 0000 0000 0000 0000 0000 0000 0000 0251 0253 0000 0000 0000 0000 0000 0000 0000 0000 0000 0000 0000 0000 0000 0000 0000 0000 0000 0000 0000 0000 0000 0000 0000 0000 0000 0000 0000 0000 0000 0000 0000
0000 0000 0000 0000 0000 0000 0206 0207 0207 0204 0204 0204 0204 0204 0204 0204 0204 0204 0204 0204 0204 0204 0204 0204 0210 0000 0000 0000 0077 0000 0000 0000 0000 0000 0000 0000 0000 0206 0207 0208 0000 0000 0000 0000 0000 0000 0000 0000 0000
0000 0000 0000 0000 0000 0000 0209 0204 0204 0204 0204 0204 0204 0204 0204 0204 0204 0204 0204 0204 0204 0204 0204 0204 0210 0000 0000 0077 0000 0000 0000 0000 0000 0000 0077 0000 0000 0209 0204 0210 0000 0000 0000 0000 0000 0000 0000 0000 0000
0000 0000 0000 0000 0000 0000 0209 0204 0204 0204 0204 0204 0204 0204 0204 0204 0204 0204 0204 0204 0204 0204 0204 0204 0210 0000 0077 0000 0077 0000 0000 0000 0000 0000 0000 0077 0000 0209 0204 0210 0000 0000 0000 0000 0000 0000 0000 0000 0000
0000 0000 0000 0000 0000 0000 0209 0204 0204 0212 0212 0212 0212 0212 0212 0212 0212 0212 0212 0212 0212 0212 0204 0204 0210 0077 0000 0077 0000 0000 0000 0000 0000 0000 0077 0000 0077 0209 0204 0210 0000 0000 0000 0000 0000 0000 0000 0000 0000
0000 0000 0000 0000 0000 0000 0209 0204 0210 0000 0000 0000 0000 0000 0000 0000 0000 0000 0000 0000 0000 0000 0209 0204 0204 0207 0207 0207 0207 0207 0207 0207 0207 0207 0207 0207 0207 0204 0204 0210 0000 0000 0000 0000 0000 0000 0000 0000 0000
0000 0000 0000 0000 0000 0000 0209 0204 0210 0000 0000 0000 0000 0000 0000 0000 0000 0000 0000 0000 0000 0000 0209 0204 0204 0204 0204 0204 0204 0204 0204 0204 0204 0204 0204 0204 0204 0204 0204 0210 0000 0000 0000 0000 0000 0000 0000 0000 0000
0000 0000 0000 0000 0000 0000 0209 0204 0210 0000 0000 0000 0000 0000 0000 0000 0000 0000 0000 0000 0000 0000 0209 0204 0204 0212 0212 0212 0212 0212 0212 0212 0212 0212 0212 0212 0212 0204 0204 0210 0000 0000 0000 0000 0000 0000 0000 0000 0000
0000 0000 0000 0000 0000 0000 0209 0204 0210 0000 0000 0000 0000 0000 0000 0000 0000 0000 0000 0000 0000 0000 0209 0204 0210 0000 0000 0000 0000 0000 0000 0000 0000 0000 0000 0000 0000 0209 0204 0210 0000 0000 0000 0000 0000 0000 0000 0000 0000
0000 0000 0000 0000 0000 0000 0209 0204 0210 0000 0000 0000 0000 0000 0000 0000 0000 0000 0000 0000 0000 0000 0209 0204 0210 0000 0000 0000 0000 0000 0000 0000 0000 0000 0000 0000 0000 0209 0204 0210 0000 0000 0000 0000 0000 0000 0000 0000 0000
0000 0000 0000 0000 0000 0000 0209 0204 0204 0207 0207 0207 0207 0207 0207 0204 0207 0207 0207 0208 0000 0000 0209 0204 0210 0000 0000 0000 0000 0000 0000 0000 0000 0000 0000 0000 0000 0209 0204 0210 0000 0000 0000 0000 0000 0000 0000 0000 0000
0000 0000 0000 0000 0000 0000 0209 0204 0204 0204 0204 0204 0204 0204 0204 0204 0204 0204 0204 0210 0000 0000 0209 0204 0210 0000 0000 0000 0000 0000 0000 0000 0000 0000 0000 0000 0000 0209 0204 0210 0000 0000 0000 0000 0000 0000 0000 0000 0000
0000 0000 0000 0000 0000 0000 0211 0212 0212 0212 0212 0212 0212 0212 0212 0212 0212 0212 0212 0213 0000 0000 0209 0204 0204 0207 0207 0204 0207 0207 0207 0207 0207 0207 0207 0207 0207 0204 0204 0210 0000 0000 0000 0000 0000 0000 0000 0000 0000
0000 0000 0000 0000 0000 0000 0000 0000 0000 0000 0000 0000 0000 0000 0000 0000 0000 0000 0000 0000 0000 0000 0209 0204 0204 0204 0204 0204 0204 0204 0204 0204 0204 0204 0204 0204 0204 0204 0204 0204 0207 0208 0000 0000 0000 0000 0000 0000 0000
0000 0000 0000 0000 0000 0000 0000 0000 0000 0000 0000 0000 0000 0000 0000 0000 0000 0000 0000 0000 0000 0000 0209 0204 0204 0212 0212 0212 0212 0212 0212 0212 0212 0212 0212 0212 0212 0204 0204 0204 0204 0210 0000 0000 0000 0000 0000 0000 0000
0000 0000 0000 0000 0000 0000 0000 0000 0000 0000 0000 0000 0000 0000 0000 0000 0000 0000 0000 0000 0000 0000 0209 0204 0210 0000 0000 0000 0000 0000 0000 0000 0000 0000 0000 0000 0000 0209 0204 0204 0212 0213 0000 0000 0000 0000 0000 0000 0000
0000 0000 0000 0000 0000 0000 0000 0000 0000 0000 0000 0000 0000 0000 0000 0000 0000 0000 0000 0000 0000 0000 0209 0204 0210 0000 0000 0000 0000 0000 0000 0000 0000 0000 0000 0000 0000 0209 0204 0210 0000 0000 0000 0000 0000 0000 0000 0000 0000
0000 0000 0000 0000 0000 0000 0000 0077 0000 0077 0000 0077 0000 0000 0000 0000 0000 0000 0000 0000 0000 0000 0209 0204 0210 0000 0000 0077 0077 0077 0077 0000 0077 0077 0077 0000 0000 0209 0204 0210 0000 0000 0000 0000 0000 0000 0000 0000 0000
0000 0000 0000 0000 0000 0000 0000 0000 0077 0000 0077 0000 0000 0000 0000 0000 0000 0000 0204 0000 0000 0000 0209 0204 0210 0000 0000 0077 0077 0077 0077 0000 0077 0077 0077 0000 0000 0209 0204 0210 0000 0000 0000 0000 0000 0000 0000 0000 0000
0000 0000 0000 0000 0000 0000 0000 0077 0000 0077 0000 0000 0000 0000 0206 0207 0207 0207 0204 0207 0207 0207 0204 0204 0210 0000 0000 0000 0000 0000 0000 0000 0000 0000 0000 0000 0000 0209 0204 0210 0000 0000 0000 0000 0000 0000 0000 0000 0000
0000 0000 0000 0000 0000 0000 0000 0000 0000 0000 0000 0000 0000 0000 0209 0204 0204 0204 0204 0204 0204 0204 0204 0204 0210 0000 0000 0077 0077 0077 0000 0077 0077 0077 0077 0000 0000 0209 0204 0210 0000 0000 0000 0000 0000 0000 0000 0000 0000
0000 0000 0000 0000 0000 0000 0000 0000 0000 0000 0000 0000 0000 0000 0211 0212 0212 0212 0212 0212 0212 0212 0204 0204 0210 0000 0000 0077 0077 0077 0000 0077 0077 0077 0077 0000 0000 0209 0204 0210 0000 0000 0000 0000 0000 0000 0000 0000 0000
0000 0000 0000 0000 0000 0000 0000 0000 0000 0000 0000 0000 0000 0077 0000 0000 0077 0000 0000 0077 0000 0000 0209 0204 0210 0000 0000 0000 0000 0000 0000 0000 0000 0000 0000 0000 0000 0209 0204 0210 0000 0000 0000 0000 0000 0000 0000 0000 0000
0000 0000 0000 0000 0000 0000 0000 0000 0000 0000 0000 0000 0000 0000 0077 0077 0000 0077 0077 0000 0077 0077 0209 0204 0210 0000 0000 0000 0000 0000 0000 0000 0000 0000 0000 0000 0000 0209 0204 0210 0000 0000 0000 0000 0000 0000 0000 0000 0000
0000 0000 0000 0000 0000 0000 0000 0206 0207 0207 0207 0207 0207 0207 0207 0207 0207 0207 0207 0207 0207 0207 0204 0204 0204 0207 0207 0207 0207 0207 0207 0207 0207 0207 0207 0207 0207 0204 0204 0210 0000 0000 0000 0000 0000 0000 0000 0000 0000
0000 0000 0000 0000 0000 0000 0000 0211 0212 0212 0212 0212 0212 0212 0212 0212 0212 0212 0212 0212 0212 0204 0204 0204 0212 0212 0212 0212 0212 0212 0212 0212 0212 0212 0212 0212 0212 0212 0212 0213 0000 0000 0000 0000 0000 0000 0000 0000 0000
0000 0000 0000 0000 0000 0000 0000 0000 0000 0000 0000 0000 0000 0000 0000 0000 0000 0000 0000 0000 0000 0009 0004 0011 0000 0000 0000 0000 0000 0000 0000 0000 0000 0000 0000 0000 0000 0000 0000 0000 0000 0000 0000 0000 0000 0000 0000 0000 0000
0000 0000 0000 0000 0000 0000 0000 0000 0000 0000 0000 0000 0000 0000 0000 0000 0000 0000 0000 0000 0000 0009 0004 0011 0000 0000 0000 0000 0000 0000 0000 0000 0000 0000 0000 0000 0000 0000 0000 0000 0000 0000 0000 0000 0000 0000 0000 0000 0000
0000 0000 0000 0000 0000 0000 0000 0000 0000 0000 0000 0000 0000 0000 0000 0000 0000 0000 0000 0000 0000 0009 0004 0011 0000 0000 0000 0000 0000 0000 0000 0000 0000 0000 0000 0000 0000 0000 0000 0000 0000 0000 0000 0000 0000 0000 0000 0000 0000
0000 0000 0000 0000 0000 0000 0000 0000 0000 0000 0000 0000 0000 0000 0000 0000 0000 0000 0000 0000 0000 0009 0004 0011 0000 0000 0000 0000 0000 0000 0000 0000 0000 0000 0000 0000 0000 0000 0000 0000 0000 0000 0000 0000 0000 0000 0000 0000 0000
0000 0000 0000 0000 0000 0000 0000 0000 0000 0000 0000 0000 0000 0000 0000 0000 0000 0000 0000 0000 0000 0009 0004 0011 0000 0000 0000 0000 0000 0000 0000 0000 0000 0000 0000 0000 0000 0000 0000 0000 0000 0000 0000 0000 0000 0000 0000 0000 0000
0000 0000 0000 0000 0000 0000 0000 0000 0000 0000 0000 0000 0000 0000 0000 0000 0000 0000 0000 0000 0000 0009 0004 0011 0000 0000 0000 0000 0000 0000 0000 0000 0000 0000 0000 0000 0000 0000 0000 0000 0000 0000 0000 0000 0000 0000 0000 0000 0000
