020 020
1533 1533 1533 1533 1533 1533 1533 1533 1533 1533 1533 1533 1533 1533 1533 1533 1533 1533 1533 1533
1533 1533 1533 1533 1533 1533 1533 1533 1533 1533 1533 1533 1533 1533 1533 1533 1533 1533 1533 1533
0266 0266 0266 0266 0266 0266 0266 0266 0266 0266 0266 0266 0266 0266 0266 0266 0266 0266 0266 0266
0266 0266 0266 0266 0266 0266 0266 0266 0266 0266 0266 0266 0266 0266 0266 0266 0266 0266 0266 0266
0266 0266 0266 0266 0266 0266 0266 0266 0266 0266 0266 0266 0266 0266 0266 0266 0266 0266 0266 0266
0266 0266 0266 0266 0266 0266 0266 0266 0266 0266 0266 0266 0266 0266 0266 0266 0266 0266 0266 0266
0266 0266 0266 0266 0266 0266 0266 0266 0266 0266 0266 0266 0266 0266 0266 0266 0266 0266 0266 0266
0266 0266 0266 0266 0266 0266 0266 0266 0266 0266 0266 0266 0266 0266 0266 0266 0266 0266 0266 0266
0266 0266 0266 0266 0266 0266 0266 0266 0266 0266 0266 0266 0266 0266 0266 0266 0266 0266 0266 0266
0266 0266 0266 0266 0266 0266 0266 0266 0266 0266 0266 0266 0266 0266 0266 0266 0266 0266 0266 0266
0266 0266 0266 0266 0266 0266 0266 0266 0266 0266 0266 0266 0266 0266 0266 0266 0266 0266 0266 0266
0266 0266 0266 0266 0266 0266 0266 0266 0266 0266 0266 0266 0266 0266 0266 0266 0266 0266 0266 0266
0266 0266 0266 0266 0266 0266 0266 0266 0266 0266 0266 0266 0266 0266 0266 0266 0266 0266 0266 0266
0266 0266 0266 0266 0266 0266 0266 0266 0266 0266 0266 0266 0266 0266 0266 0266 0266 0266 0266 0266
0266 0266 0266 0266 0266 0266 0266 0266 0266 0266 0266 0266 0266 0266 0266 0266 0266 0266 0266 0266
0266 0266 0266 0266 0266 0266 0266 0266 0266 0266 0266 0266 0266 0266 0266 0266 0266 0266 0266 0266
0266 0266 0266 0266 0266 0266 0266 0266 0266 0266 0266 0266 0266 0266 0266 0266 0266 0266 0266 0266
0266 0266 0266 0266 0266 0266 0266 0266 0266 0266 0266 0266 0266 0266 0266 0266 0266 0266 0266 0266
0266 0266 0266 0266 0266 0266 0266 0266 0266 0266 0266 0266 0266 0266 0266 0266 0266 0266 0266 0266
1566 0266 0266 0266 0266 0266 0266 0266 0266 0266 0266 0266 0266 0266 0266 0266 0266 0266 0266 1567
